6 5
A S A A A S
A S A S A S
A S A S A S
A S A S A S
A A A S A A
