5 5
A S A A A
A S A S A
A S A S A
A S A S A
A A A S A
